*****************
*C#...........C.*
*..........#...%*
*..*.....@......*
*%..............*
*..*.#......*%..*
*......*.#...*..*
*..C............*
*...*...........*
*.........~~~...*
*...#.....~d~...*
*%C..........C..*
*****************