*****************
*...............*
*.@.........#...*
*..*............*
*...............*
*..........*....*
*...............*
*...............*
*..........*....*
*.........~~~...*
*.........~.~...*
*...............*
*****************