*................
*.@..............
*..*.............
*................
*..........*.....
*................
*................
*..........*.....
*................
*................
*................
*................